1, T, 2, T, T, 1
2, 2, 2, 2, 2, 1
T, 1, G, G, 1, 1
3, 3, 1, G, 1, T
T, T, 1, G, 1, 1
2, 2, 1, G, G, G
