1, 1, 1, 1, 1, 1, _, 2, _, 2, 2, _, 1, 1, _
_, 2, 1, _, 2, 2, 1, 2, 1, 2, _, 2, 1, 1, 1
_, _, 1, 2, _, 1, _, 1, 2, 3, 3, 2, 2, 1, 1
1, 1, _, 1, 2, 2, 1, 2, _, _, 2, _, 3, _, 2
_, 1, 1, 2, 2, _, 1, 2, _, _, 3, 3, 5, _, 2
1, 2, _, 2, _, 2, 1, 1, 1, 1, 1, _, _, 3, 2
_, 5, 4, _, 2, 1, _, _, _, _, 1, 2, 4, _, _
_, _, _, _, 1, _, _, 1, 1, 1, _, 1, 4, _, 3
_, 4, 3, 2, 1, _, _, 1, _, 1, _, 1, _, _, _
1, 1, _, _, _, _, _, 1, 1, 2, 2, _, 4, 4, 3
_, _, _, _, _, _, 1, 1, 1, 1, _, _, 3, _, _
_, _, _, 1, 1, 2, 2, _, 1, 2, 5, _, 5, 3, 2
_, _, _, 1, _, 3, _, 3, 1, 1, _, _, _, 1, _
2, 2, _, 2, 3, 6, _, 3, _, 2, 4, _, 4, 2, 1
_, 1, _, 1, _, _, _, 2, _, 1, _, 2, 2, _, 1