_, 2, _, 2, _
_, 5, 3, 4, _
_, _, _, _, 4
_, _, _, _, _
1, _, 3, _, _