_, 2, _, _, _, _, 4, _
2, 4, _, _, 4, 4, _, _
_, _, 3, 2, 2, _, _, _
4, 4, _, _, 2, _, _, 3
_, _, 3, 2, 3, _, _, _
4, _, _, 3, _, 4, 6, _
4, _, 6, _, 4, _, _, _
_, _, _, 3, _, _, 4, _