_, _, _, _, _, _, _
_, 7, _, 5, _, 7, _
_, _, 2, 2, 2, _, _
_, 5, 2, _, 2, 5, _
_, _, 2, 2, 2, _, _
_, 7, _, 5, _, 7, _
_, _, _, _, _, _, _