1, _, 1, _, 1, _, 2, _, 1, 1
1, _, _, _, _, _, _, _, _, 1
_, _, 3, _, _, 2, _, _, _, _
_, _, _, _, 1, _, _, 3, 3, _
1, 1, 1, _, _, _, _, 2, _, 3
_, _, _, _, 0, _, 1, _, 3, _
_, _, _, 1, _, _, 2, _, 4, _
0, _, _, 3, _, _, 4, _, _, _
_, 3, _, 2, _, _, 4, _, _, 2
_, _, _, _, _, _, _, 2, _, 0