1, _, 2, _, _, 1
2, 2, 2, 2, 2, 1
_, 1, _, _, 1, 1
3, 3, 1, _, 1, _
_, _, 1, _, 1, 1
2, 2, 1, _, _, _